TileSize: 40.0
Rows: 18
Columns: 32
00000000500000000000000500000000
00000000000000000000000000000000
00000000000000000000000000000000
00000000500000505000000500000000
66600666100000505000000266600666
00000000000000505000000000000000
00000000000000505000000000000000
00000000000004102300000000000000
00000000066661000266660000000000
00000000000000000000000000000000
00000000066663000466660000000000
00000000000002304100000000000000
00000000000000505000000000000000
66600666300000505000000466600666
00000000500000505000000500000000
00000000000000505000000000000000
00000000000000000000000000000000
00000000500000000000000500000000